# # # # # # # # # # # #
. . . . . . . . . . . #
# . # . # # # # # . # #
# . # . . . . . # . . #
# . # . # . # # # . # #
# . # . # . . . # . . #
# . # # # . # # # # # #
# . . . # . . . . . . #
# . # . # # # # # . # #
# . # . . . . . # . . .
# . # . # . # . # . # #
# # # # # # # # # # # #